{
    "0": "\n",
    "1": " ",
    "2": "!",
    "3": "$",
    "4": "%",
    "5": "&",
    "6": "'",
    "7": "(",
    "8": ")",
    "9": "*",
    "10": ",",
    "11": "-",
    "12": ".",
    "13": "/",
    "14": "0",
    "15": "1",
    "16": "2",
    "17": "3",
    "18": "4",
    "19": "5",
    "20": "6",
    "21": "7",
    "22": "8",
    "23": "9",
    "24": ":",
    "25": ";",
    "26": "?",
    "27": "@",
    "28": "A",
    "29": "B",
    "30": "C",
    "31": "D",
    "32": "E",
    "33": "F",
    "34": "G",
    "35": "H",
    "36": "I",
    "37": "J",
    "38": "K",
    "39": "L",
    "40": "M",
    "41": "N",
    "42": "O",
    "43": "P",
    "44": "Q",
    "45": "R",
    "46": "S",
    "47": "T",
    "48": "U",
    "49": "V",
    "50": "W",
    "51": "X",
    "52": "Y",
    "53": "Z",
    "54": "a",
    "55": "b",
    "56": "c",
    "57": "d",
    "58": "e",
    "59": "f",
    "60": "g",
    "61": "h",
    "62": "i",
    "63": "j",
    "64": "k",
    "65": "l",
    "66": "m",
    "67": "n",
    "68": "o",
    "69": "p",
    "70": "q",
    "71": "r",
    "72": "s",
    "73": "t",
    "74": "u",
    "75": "v",
    "76": "w",
    "77": "x",
    "78": "y",
    "79": "z",
    "80": "\u00ea",
    "81": "\u00f4",
    "82": "\u201c",
    "83": "\u201d"
}